10021x
2222122211112212111222122212121112121121111221211121212212111211221112212211121121112111111222121212
2222211112122221212211212211221121122221212221122222222112211211121212222211212222112122111111211122
1212121221222111121112112122122221121221122211122121112121211221112211212111112212121121121222122121
2111111122212211122111221211122212122112211112221212122212111211112112222222122122212212121221211211
2211112122112212112221222211221221112112212112221212112121112122122122222211221211122211121111122112
1212122112211111121121211221112222112111211122111211111212111111211222121121211111211122211211122111
2221221111212221212122121122211111112222221112122121121112212221112211221222212212221111222211211212
2111121112211221121112121111121212121221221221222121121121122121122211112121122221121112222211222121
1222121211211121222122221121122111221222121212112221211211221212211121111112211212122211221111111212
2221122221211212121112221212221221212112212221112212222212121221122211122121212121221212122212122111
1211222112212111121211122122111212122121111212211221222222112221212122211211121211111112222221211111
1111112212212212112122121222222121211121212111112212221121212212111122122111112122111212111121212122
2211222111222221222221222211122211221111111222112121211112121122112222221121212112212122112111211121
1111212211211222121111211211211122121211211121212121122122111122221221111212212211221221121211121222
1111211111121112112122211212112212121111222111221122112111112111221211111221222211121222111221222121
1112121121111121211221222211112112212121211121211211212112222112121112222121222222211221221222121121
2121121121221222111222222221111112222122211211112121111221111211211211211122221221111212111212121112
2221122122211122211122212222222221111111222221221221122112111112211121122212211222112122211212222221
1111222111121222221211222111121222112121121122222211111211112121212121221221222121122112211112111112
2122112211222121111212122122111221111212121212111122221222212112222212212112221221212211211121211112
1112211111121122112112212111222212221221112112221221121112221221112222111222221111111121221112111221
1212222222121211211121121221122121121211121111222111212112122122122111211112222211121111121121211222
2111222121222112121111111111112211211212112222222122112211112222211212112111211112112211112122222222
1122221212222222212111212122121121222111222221212221222211121211111121111212222221121221121211222121
2122211121211222122212211111111122121221211112111221211211112112221222121211121221222222112112121112
1111121122222112111111222212211222122222212221211212212222221121112212111111112111112212212122121122
2112211222122122121112112121121121121111122122222222211111211111122221211211221212221212222221221212
1211211211222121222112112112111122222111121221122111112121122212211122222121112121222212111121121211
2211121221122212222121212111111122112221222112122121212122211121112121221212221221222221222211122112
1122112222222221111112122121122212211221111222111222121211212111112112112121112122222121111122211221
1122212121212211221111211211212211221211212212211112221122221221121211221121212212111211212222212111
2122122122211121212112112112222222111122121111211121121211212122122211121112121111211111121121122222
2212222121112212111122211111121212111121212111222221121112211121211222222122122211212211121211222111
2222121111211111222221221111111111221222211221111121121222112121221222222221121222212221211222111121
2222112122122212212222111111111112221211211211122212211112121222211211121221121122221211111222111212
1121122122122112112211221212122121111122211111212211221221212112111221211112112112222121211221211121
2112222222111122112122111111122211111112112221212121121121122211112211121211111212121212111212211211
2122211221122122211111212222112211221121112222221212111222222122122212121122121212211222212112212221
2122211111121212121212121211222112211222111111122221222211112211112122221112122112111211211221212212
2222122111121121111222212122111221122222121222222212222121211222222221111221222222121111212221112211
2221112222122212222121122222222222222211111222111221122211212211222112111221212112221212122211221222
2122211122222122121221121222122222211112122122212122121221211122211111111221112222212121211222112121
1121222121211221222211221222112222122121111212211121221212122221211212111222212121121122211122111122
1212221222112221121221222221221222121111211212111111222111211222122222112222211221112221122111112111
2112122221111212122222121212111112211122212121221111221221221212121111121222111122121212222211221112
1122211211112212221211111111111111221211121121222111212211222112112212211212221121112112111212212212
1221222222111122221111121221122221121211222222122212221222222111121222211111221111111212111121221221
2221122121122111212211121221121111112121221212212222122111212111221211112112121212212112122221211112
2122212111112212211222221122211111222221212222111211122121112112111122111122212212212111111222122121
2222112222112121122122221221122212112111111121111122221212222112122222221112111121112212121121121212
2211211222121222221122221111111212222111221211221112222112121211222212222121211211121212112121111221
1222121212121222111112112122211211212121112211111111122122111112212221121221221222122122111212112121
2122112221112212112222211212212121112112222222212112222212122111111122121212121212111121222121221212
1222121112122122221212111122122222222211112211111222222222112211112121121211212221212121111111222221
2112111122112221211221121111212211221112212221111111122221111112112211122212221122122221222212212222
2222212212122211122111211221222222111112222121212121111221112211122112122121221221211112221122111212
1121211112222222222222112211122122112112222122211112222221122221222221222211211112222221212212211212
2122121222112121112111212221112211122112221221121211121222212122211122122212111221221122221221121112
1221112212211221211122222212112111122111221122122111121122222222112221111222121211121221112111222212
1211111111112112211111122212121221111211121222212221112121221112211221222121112122112111212212212212
2122222122212122121221122222212122111111212122222121212111222122212111112121222221122112122111212221
1221211211221112212222122122221221111112222122112122111111111222122112122111222222112121112112121211
2111122121112111221121122222211122122211121221122111221222122121121121211211122211221121111122221121
1122212111222111211112211122222212122121122121211212212122211112111112111112122212111211221112211122
2221211121122122121211111211211121212211112122122222212112122222122211222111112122111211122211122222
1122211111221121222121221211121111212222111221212222121112111122221122222222112112111221212121112221
1221212221222221122122222211111211111122221111211122111212121122212121211122122122222121122211112112
1112211221122222121112112122111212211112111111221221122121111121121112221212112211222211212211221122
1121211221121212121112112121211221212112222122212222111222121221221211211122222121222221221221122112
1121211212212122121121222121221121212212111211121122222221111111111112222221221211212212121121222112
2112222212121222221211111212222221112222112221212121112112211112222121212212221111221221121111222211
2111212121112111122111111211121221212212112222211211112112111111112211212212122112111111121111121221
1112221221112212212212121121112222112221112111112211222111112121222212211112122111112121111222122121
2121221212211111211211122211111221221221121221111111121221112122212111111212211222222221112122111221
1122122112222221211112122111121122211122111211221111212222222121211111121211111121222111211112222211
2111122221212221221112211212212211221221211112111122122121112122221212122122122111222212121212221212
2221222222122111121121112112212112222212112222212212212122111222111211112212112211221122122111121221
2221221121211211121111121221112212112222212212211111221211212211212112112212121221111121122211122221
2212122112222122211112212211222211112212111112221111222211111212122211211111121122112222222112122111
2122222121121112121222211121212121122222112222111112121111121211222222211211111221111112222121111221
2112121122221211212212121121111212112122112211212212111122221121121111221212122122122112221112122121
2111111212121121111222221111111221111121121211122111112221211221111122112122211121211122222211221122
2211122211222222222122221212112211122121212212221121212222221222112221112222122122222221112222121122
2222121121222111211121111222221212121221221111211111222222222211112222121111221111122112121111221222
1112111212122212111111121121221111122211221112122211222111221121221121212122121222122211112122112122
2221221211112212222111112211221221211222212121221221212221211122121212111121111111121211111122221211
1221221112112122222122111211122111111112112211212121112222222111122221222121122122221111212222112221
2212211211222212212212121221212222121111111111211222221221221121111212112122111211212211211122111222
2122211221211112221221112221221211111212112222111122111211222112111112121222111212112111211122112211
1212221121211112211121112112221212222211211112222111212222212122211122111222122111222211111122112111
2121212122111122111122121121221112221211211212121221121121211222121212211121111212111121221221221112
2111122211121211212212111121121222211211112122121221211111121122112111222211212111212211222211212121
2111222222221112122121122112112121212111122122112221221121112212212121121212221212122122122111221122
2111222112211121222211211221222121121221211221212221111222222221112111111122222112222121221222121111
2222121112221121112122221212122122111112121122111222222212121211212211222122212121222121211212122221
2221121111221112221112122112212112221222212111221211221112112122122221112222112211211222212122122111
2222112112111121111211222111212112221121112122222111122111112212222222222212112212112221221121111121
1111212112111222211222221111121112222211221211112222222121111112221122212221221211121122211122222122
2112221211111221221211222121221122122221212112211111212121212221121211111221212111212122121111211222
2212222222122111221222222112121221121112122122211112222221221121212221212122122112221212211121222222
