12.o*
o.........ooo
........o.ooo
.....o....ooo
.........o..o
.....oo...ooo
.o.ooo....ooo
.....o....ooo
.........o..o
o...ooo...ooo
...ooo....ooo
.....o....ooo
.........o..o
