11111111111111111111111111111111111111111111111111111111111111111111111111111111111111111111111111
1C00000000111C0000000000000001000000001000000000000001000000000000000000000000000000000001100000C1
10000000000011100011111111110111110010100000000000000100000000000000011001111110111111000000000001
10000000000000111000111111110111110010100000000000000000000000000000001100111110111110011001001001
1000000000000000111000111111011E110010100011111100000100000000000000000110011110111100110010001001
10000000000000000011100011110100000010100000000100000100000000000000000011001110111001100110111001
1000000000011000000011100011P111111110100000000100000100001111111111110001100110110011001000001001
10001C000000000000000011100001000000001000000000000001000010C000000001000011001C100110011111101001
100011000000000000000000111001000000001000000001000001C0001000000000010000C11001001100100000001001
10000000000000000010000000100100111111111111110111111111111000000000011111111100011001101111111001
10000001111000000010000000000C00000000M00000000000000000000000000000000000000000110010000C00001001
10000000000000000000000000000000000000000000000000000000000000000000000000000001100111111111101001
10000000000001000000000000000101111110101111111111111111111111111111111111100011001000000000001001
10000000000000000000000000000100111100100000000000000000000000000000000000100010011011111111111001
10000000010000000000000010000100011000100000000000100110010000000000000000100010010000000000000001
10000000000000000001000000000100000000100000000000000000010000000000000000100010011111111111111001
1000000000000000000100000000010001100010000000000000000001000000000000000000001C000000000000000001
10001100000000011000000000000100111100111111111001111111111111111110011111111111111110000000000001
1C0000000000000000000000000001C1111110000000000000000000000000000000000000000000000000000000000001
11111111111111111111111111111111111111111111111111111111111111111111111111111111111111111111111111
